라인하르트 = Reinhart
베르투스 데 그라디아스 = Vertus de Gradias
템플 = the Temple
코노 린트 = Connor Lint
카이에르 비오덴 = Kaier Vioden
에르히 데 라파에리 = Erhi de Raffaeli
하인리히 폰 슈바르츠 = Heinrich von Schwartz
리아나 데 그란츠 = Riana de Granz
헤리엇 드 생투안 = Harriet de Saint=Ouen
사비올린 타나 = Sabioleen Tana
에핀하우저 선생 = Mr. Effenhauser
머스트랭 선생 = Ms. Mustang
클리프만 = Cliffman
자기암시 = Self-Deception
마력강화 = Mana Reinforcement
언령 = Incantation
초능력 = supernatural power
A 클래스 = Class A
B 클래스 = Class B
연무장 = training grounds
게이트 사태 = Gate Incident
샤나펠 = Shanapell
마력운용 = Mana Manipulation
마력감응 = Mana Attunement
안나 데 게르나 = Anna de Gerna
델핀 이자드라 = Delphine Izadra
라니언 세소르 = Lanian Sesor
르디나 = Rudina
아드리아나 = Adriana
스칼렛 = Scarlett
크리스티나 = Cristina
엘레리스 = Eleris
사르케가르 = Sarkegar
오대주신 = Five Great Gods
성전기사단 = Order of the Holy Knights
세레스 반 오웨느 = Ceres van Owenne
연무장 = training grounds
마법연구회 = Magic Research Club